Easy does it...
45
4
11111111111111111111111111111111111111111111111111
11111111111111111111111111111111111111111111111111
11000000000000000000000000000000000000000000000011
11000000000000000000000000000000000000000000000011
11000000000000000000000000000000000000000000000011
11000000000000000000000000000000000000000000000011
11000000000000000000000000000000000000000000000011
11000011111111111111111111111111111111111111000011
11000011111111111111111111111111111111111111000011
11000011100000111111111111111111110000000011000011
11000011100000001111111111111111100000000011000011
11000011100000000111111111111111000000000011000011
11000011100000000011111111111110000000000011000011
11000011100000000001111111111110000000000011000011
11000011100000000000111111111100000001000011000011
11000011100000000000011111111000000011000011000011
11000011100001000000021111110000000111000011000011
11000011100001100000021111100000000111000011000011
11000011100001110000021111100000001111000011000011
11000011100001111000021111000000011111000011000011
11000011100001111100021110000000111111000011000011
11000011100001111111111100000001111111000011000011
11000011100001111111111000000001111111000011000011
11000011100001111111110000000011111111000011000011
11000011100001111111100000000111111111000011000011
11000011100001111111100000001111111111000011000011
11000011100001111111000000011111111111000011000011
11000011100001111110000000111111111111000011000011
11000011100001111100000001111111111111000011000011
11000011100001111000000001111111111111000011000011
11000011100001111000000011111111111111000011000011
11000011100001110000000111111111111111000011000011
11000011100001100000001111111111111111000011000011
11000011100001000000011111111111111111000011000011
11000011100000000000011111111111111111000011000011
11000011100000000000111111111111111111000011000011
11000011100000000001111111111111111111000011000011
11000011100000000011111111111111111111000011000011
11000011100000000111111111111111111111000011000011
11000011100000001111111111111111111111000011000011
11000011100000011111111111111111111111000011000011
11000011100001111111111111111111111111000011000011
11000011111111111111111111111111111111000011000011
11000011111111111111111111111111111111000011000011
11000000000000000000000000000000000000000011000011
11000000000000000000000000000000000000000011000011
11000000000000000000000000000000000000000011000011
11000000000000000000000000000000000000000011000011
11111111111111111111111111111111111111111111111111
11111111111111111111111111111111111111111111111111
