Navigate the circle!
19.0
46.0
11111111111111111111111111111111111111111111111111
11111111111111111111111111111111111111111111111111
11111111111111111111010000000111111111111111111111
11111111111111111000010000000000111111111111111111
11111111111111000000010000000000000111111111111111
11111111111110000000010000000000000011111111111111
11111111111000000000010000000000000000111111111111
11111111110000000000010000010000000000011111111111
11111111100000000011110000011111000000001111111111
11111111000000001111110000011111110000000111111111
11111110000000111111110000011111111000000011111111
11111100000001111111110000011111111100000001111111
11111100000011111111110000011111111110000000111111
11111000001111111111110000011111111111000000111111
11110000001111111111110000011111111111100000011111
11110000001111111110210000000111111111100000011111
11110000011111111100210000000101111111110000001111
11100000111111110000210000000000111111110000001111
11100000111111110000211000000000011111111000001111
11100000111111100000211111100000001111111000001111
11000001111111100000211111110000001111111000000111
11000001111111100000111111111100001111111100000111
11000001111111100001111111111100000111111100000111
11000001111111000001111111111110000111111100000111
11000001111111000001111111111110000111111100000111
11000001111111000001111111111100000111111100000111
11000001111111000001111111111100000111111100000111
11000001111111100001111111111100001111111100000111
11000001111111100000111111111000001111111100000111
11100001111111110000011111100000011111111100000111
11100001111111111000000000000000111111111000001111
11100000111111111000000000000000111111111000001111
11110000111111111100000000000001111111110000001111
11110000011111111110000000000111111111110000011111
11110000001111111111000000011111111111100000011111
11111000000111111111111111111111111111000000111111
11111100000011111111111111111111111110000001111111
11111100000001111111111111111111111100000001111111
11111110000000111111111111111111111000000011111111
11111111000000001111111111111111110000000111111111
11111111100000000111111111111111000000001111111111
11111111110000000000011111111100000000011111111111
11111111111000000000000111100000000000111111111111
11111111111100000000000000000000000011111111111111
11111111111111000000000000000000000111111111111111
11111111111111110000000000000000011111111111111111
11111111111111111111000000000011111111111111111111
11111111111111111111111111111111111111111111111111
11111111111111111111111111111111111111111111111111
11111111111111111111111111111111111111111111111111
