Press <color=blue>up</color> on the left thumbstick
3.0
5.0
11111111
10000001
10222201
10222201
10222201
10000001
10000001
10000001
10000001
10000001
10000001
10000001
10000001
10000001
10000001
10000001
10000001
10000001
10000001
10000001
10000001
10000001
10000001
10000001
10000001
10000001
10000001
10000001
10000001
10000001
10000001
10000001
10000001
10000001
10000001
10000001
10000001
10000001
10000001
10000001
10000001
10000001
10000001
10000001
10000001
10000001
10000001
10000001
10000001
10000001
11111111
