Get to the goal!
111111111111111111111111
100000000000000000000001
100000000000000000002201
100000000000000000002201
100000000000000000000001
111111111111111111111111
