Get to the goal!
5.0
29.0
1111111111111111111111111111110111111011111111111111111111111111111111111111111111111111111111111111111111111111111111111111111111
1111111111111111111111111100000000000000000011111111111111111111111000000000000000000111111111111111111111111111111111111111111111
1111111111111111111111110000000000000000000000001111111111111111110000000000000000001111111111111111111111111111111111111111111111
1111111111111111111111000000000000000000000000000011111111111111100000000000000000111111111111111111111111111111111111111111111111
1111111111111111111110000000000000000000000000000000111111111111000000000000000001111111111111111111111111111111111111111111111111
1111111111111111111100000000000000000000000000000000001111111100000000000000000011111111111111111111111111111111111111111111111111
1111111111111111111000000000000000000000000000000000000111111000000000000000000111111111111111111111111111111111111111111111111111
1111111111111111110000000000011111111111000000000000000001110000000010000000001111111111111111111111111111111111111111111111111111
1111111111111111100000000001111111111111111100000000000001100000000110000000011111111111111111111111111111111111111111111111111111
1111111111111111000000000111111111111111111111100000000000000000001100000000111111111111111111111111111111111111111111111111111111
1111111111111111000000001111111111111111111111111000000000000000001100000001111111111111111111111111111111111111111111111111111111
1111111111111110000000111110000000000000111111111100000000000000011000000011100001111111111111111111111111111111111111111111111111
1111111111111100000001111100000000000000000111111111000000000000111000000000000000000111111111111111111111111111111111111111111111
1111111111111000000011111000000000000000000001111111100000000001110000000000000000000000111111111111111111111111111111111111111111
1111111111111000000011110000000000000000000000011111110000000011110000000000000000000000011111111111111111111111111111111111111111
1111111111110000000111100000000000000000000000001111111000000011100000000000000000000000001111111111111111111111111111111111111111
1111111111110000001111000000000000000000000000000011111000000111000000000000000000000000000001111111111111111111111111111111111111
1111111111110000001110000000000011111111111000000001111100000111000000000000000000000000000000011111111111111111111111111111111111
1111111111100000011100000000001111111111111111000000011100000111000000000000000000000000000000001111111111111111111111111111111111
1111111111100000011000000001111111000000000011100000011100001110000000000001111000000000000000000011111111111111111111111111111111
1111111111100000110000000011111110000000000000000000001100001100000000011111111111111000000000000001111111111111111111111111111111
1111111111000000100000000111111100000000000000000000001100011100000001111111111111111110000000000000111111111111111111111111111111
1111111111000000100000001111110000000000000000000000000110011000000111111111111111111111110000000000011111111111111111111111111111
1111111111000000000000011111000000000000000000000000000110011000001111111111111111111111111000000000001111111111111111111111111111
1111111111000000000000111100000000000000000000000000000010110000111111111111111111111111111100000000001111111111111111111111111111
1111111111000000000001111100000000000011111111111000000011110001111111111111111111111111111111000000000111111111111111111111111111
1111111111000000000001111000000000001111111111111111000011100011111111111111111111111111111111000000000111111111111111111111111111
1111111111000000000011110000000000111111111111111111110011100111100000000111111111111111111111110000000011111111111111111111111111
1111111111100000000011100000000001111111111111111111110011111110000000000000000111111111111111111000000011111111111111111111111111
1111111111100000000111000000000111111110000000011111111111111100000000000000000000000111111111111000000001111111111111111111111111
1111111111100000000111000000001111100000000000000011001111111100000000000000000000000000000111111100000001111111111111111111111111
1111111111110000001110000000011111000000000000000000001111111100000000000000000000000000000000011100000000111111111111111111111111
1111111111111000001100000000011100000000000000000000011110111100000000000000000000000000000000000110000000111111111111111111111111
1111111111111000001000000000111000000000000000000000111100011110000000000000000000000000000000000000000000011111111111111111111111
1111111111111100010000000001100000000000100000000001100000001111000000000000000000000000000000000000000000011111111111111111111111
1111111111111111110000000011000000000011000000000011000000000111100000000111110000000000000000000000000000011111111111111111111111
1111111111111111100000000110000000001111000000001110000000000111100000000111111111110000000000000000000000011111111111111111111111
1111111111111111100000001100000000011110000000011100000000000011110000000001111111111111000000000000000000011111111111111111111111
1111111111111111000000011000000001111100000000111100000100000001111000000001111111111111111100000000000000011111111111111111111111
1111111111111111000000110000000011111000000001111100000110000000111000000001111111111111111111110000000000011111111111111111111111
1111111111111111000000100000000111110000000011111000001111000000111000000000111111111111111111111000000000001111111111111111111111
1111111111111111000001100000001111110000000111110000001111000000011100000000111111111111111111111110000000001111111111111111111111
1111111111111111000011000000111111100000001111110000011111100000011100000000011111111111111111111111000000001111111111111111111111
1111111111111111000000000000111111000000001111100000011111100000001110000000011111111111111111111111100000001111111111111111111111
1111111111111110000000000001111110000000011111100000011111100000001110000000011111111111111111111111110000001111111111111111111111
1111111111111110000000000111111100000000111111000000011111110000001110000000011111111111111111111111111000001111111111111111111111
1111111111111110000000001111111000000001111111000000111111110000001111000000011111111111111111111111111000001111111111111111111111
1111111111111110000000001111111000000011111111000000111111111000001111000000011111111111111111111111111100001111111111111111111111
1111111111111110000000011111110000000111111111000000111111111000001111000000011111111111111111111111111111001111111111111111111111
1111111111111110000000111111100000000111111110000001111111111000001111000000011111111111111111111111111111101111111111111111111111
1111111111111110000000111111100000000111111110000001111111111000001111000000111111111111111111111111111111111111111111111111111111
1111111111111110000000111111000000001111111100000011111111111000001110000000111111111111111111111111111111111111111111111111111111
1111111111111110000000111111000000001111111100000011111111111000001110000000111111111111111111111111111111111111111111111111111111
1111111111111110000000111110000000011111111000000111111111111000001110000000111111111111111111111111111111111111111111111111111111
1111111111111111000001111110000000111111111000000111111111111000001110000000111111111111111111111111111111111111111111111111111111
1111111111111111100001111100000001111111111000000111111111110000001100000001111111111111111111111111111111111111111111111111111111
1111111111111111110001111100000001111111110000001111111111110000001100000001111111111111111111111111111111111111111111111111111111
1111111111111111111111111000000011111111110000001111111111110000001100000001111111111111111111111111111111111111111111111111111111
1111111111111111111111111000000011111111110000001111111111100000011000000001111111111111111111111111111111111111111111111111111111
1111111111111111111111110000000111111111100000011111111111100000011000000001111111111111111111111111111111111111111111111111111111
1111111111111111111111110000000111111111100000011111111111100000011000000011111111111111111111111111111111111111111111111111111111
1111111111111111111111100000001111111111100000011111111111100000011000000011111111111111111111111111111111111111111111111111111111
1111111111111111111111000000001111111111000000011111111111100000010000000111111111111111111111111111111111111111111111111111111111
1111111111111111111111000000001111111110000000111111111111100000010000000111111111111111111111111111111111111111111111111111111111
1111111111111111111110000000011111111110000000111111111111000000010000001111111111111111111111111111111111111111111111111111111111
1111111111111111111100000000011111111100000000111111111111000000000000001111111111111111111111111111111111111111111111111111111111
1111111111111111111100000000111111111100000000111111111111000000000000011111111111111111111111111111111111111111111111111111111111
1111111111111111111000000000111111111000000000111111111110000000000000111111111111111111111111111111111111111111111111111111111111
1111111111111111111000000001111111111000000001111111111110000000000001111111111111111111111111111111111111111111111111111111111111
1111111111111111111000000001111111111000000001111111111110000000000011111111111111111111111111111111111111111111111111111111111111
1111111111111111111000000001111111111000000001111111111110000000000111111111111111111111111111111111111111111111111111111111111111
1111111111111111110000000001111111111000000011111111111100000000011111111111111111111111111111111111111111111111111111111111111111
1111111111111111110000000011111111110000000011111111111100000000111111111111111111111111111111111111111111111111111111111111111111
1111111111111111110000000011111111110000000111111111111000000001111111111111111111111111111111111111111111111111111111111111111111
1111111111111111100000000011111111110000000111111111111000000111111111111111111111111111111111111111111111111111111111111111111111
1111111111111111100000000111111111110000000111111111111100011111111111111111111111111111111111111111111111111111111111111111111111
1111111111111111100000000111111111110000000111111111111111111111111111111111111111111111111111111111111111111111111111111111111111
1111111111111111100000000111111111110000000111111111111111111111111111111111111111111111111111111111111111111111111111111111111111
1111111111111111100000000111111111110000000111111111111111111111111111111111111111111111111111111111111111111111111111111111111111
1111111111111111100000000111111111110000000111111111111111111111111111111111111111111111111111111111111111111111111111111111111111
1111111111111111100000000111111111110000000111111111111111111111111111111111111111111111111111111111111111111111111111111111111111
1111111111111111000000000111111111110000000111111111111111111111111111111111111111111111111111111111111111111111111111111111111111
1111111111111111000000000111111111110000000111111111111111111111111111111111111111111111111111111111111111111111111111111111111111
1111111111111111000000000111111111110000000111111111111111111111111111111111111111111111111111111111111111111111111111111111111111
1111111111111111000000000111111111110000000111111111111111111111111111111111111111111111111111111111111111111111111111111111111111
1111111111111111000000001111111111110000001111111111111111111111111111111111111111111111111111111111111111111111111111111111111111
1111111111111111000000001111111111110000001111111111111111111111111111111111111111111111111111111111111111111111111111111111111111
1111111111111111000000001111111111110000001111111111111111111111111111111111111111111111111111111111111111111111111111111111111111
1111111111111111000000001111111111110000001111111111111111111111111111111111111111111111111111111111111111111111111111111111111111
1111111111111111000000001111111111110000001111111111111111111111111111111111111111111111111111111111111111111111111111111111111111
1111111111111111000000001111111111110000001111111111111111111111111111111111111111111111111111111111111111111111111111111111111111
1111111111111111100000001111111111110000001111111111111111111111111111111111111111111111111111111111111111111111111111111111111111
1111111111111111100000001111111111110000001111111111111111111111111111111111111111111111111111111111111111111111111111111111111111
1111111111111111100000001111111111110000001111111111111111111111111111111111111111111111111111111111111111111111111111111111111111
1111111111111111100000001111111111110000001111111111111111111111111111111111111111111111111111111111111111111111111111111111111111
1111111111111111100000001111111111110000001111111111111111111111111111111111111111111111111111111111111111111111111111111111111111
1111111111111111100000001111111111110000001111111111111111111111111111111111111111111111111111111111111111111111111111111111111111
1111111111111111100000001111111111110000000111111111111111111111111111111111111111111111111111111111111111111111111111111111111111
1111111111111111110000001111111111110000000111111111111111111111111111111111111111111111111111111111111111111111111111111111111111
1111111111111111110000000111111111110000000111111111111111111111111111111111111111111111111111111111111111111111111111111111111111
1111111111111111110000000111111111110000000011111111111111111111111111111111111111111111111111111111111111111111111111111111111111
1111111111111111110000000111111111111000000011111111111111111111111111111111111111111111111111111111111111111111111111111111111111
1111111111111111110000000111111111111000000011111111111111111111111111111111111111111111111111111111111111111111111111111111111111
1111111111111111111000000111111111111000000011111111111111111111111111111111111111111111111111111111111111111111111111111111111111
1111111111111111111000000111111111111000000001111111111111111111111111111111111111111111111111111111111111111111111111111111111111
1111111111111111111000000111111111111000000001111111111111111111111111111111111111111111111111111111111111111111111111111111111111
1111111111111111111000000011111111111100000001111111111111111111111111111111111111111111111111111111111111111111111111111111111111
1111111111111111111000000011111111111100000001111111111111111111111111111111111111111111111111111111111111111111111111111111111111
1111111111111111111000000011111111111100000000111111111111111111111111111111111111111111111111111111111111111111111111111111111111
1111111111111111111000000011111111111100000000111111111111111111111111111111111111111111111111111111111111111111111111111111111111
1111111111111111111000000011111111111100000000111111111111111111111111111111111111111111111111111111111111111111111111111111111111
1111111111111111111100000011111111111110000000111111111111111111111111111111111111111111111111111111111111111111111111111111111111
1111111111111111111100000001111111111110000000011111111111111111111111111111111111111111111111111111111111111111111111111111111111
1111111111111111111100000001111111111110000000000000000001111111111111111111111111111111111111111111111111111111111111111111111111
1111111111111111111100000001111111111111000000000000000000011111111111111111111111111111111111111111111111111111111111111111111111
1110000000000000000000000000111111111111000000000000000000000011111111111111111111111111111111111111111111111111111111111111111111
1000000000000000000000000000011111111111100000000000000000000000111111111111111111111111111111111111111111111111111111111111111111
1000000000000000000000000000011111111111110000000000000000000000011111111111111111111111111111111111111111111111111111111111111111
1000000000000000000000000000011111111111110000000000000000000000000111111111111111111111111111111111111111111111111111111111111111
1000000000000000000000000000011111111111111000000000000000000000000001111111111111111111111111111111111111111111111111111111111111
1000000000000000000000000000011111111111111100000011000000000000000000011111111111111111111111111111111111111111111111111111111111
1000000011111111111111100000001111111111111100000001111111000000000000000111111111111111111111111111111111111111111111111111111111
1011111111111111111111100000001111111111111100000001111111111000000000000011111111111111111111111111111111111111111111111111111111
1111111111111111111111100000001111111111111100000001111111111110000000000000111111111111111111111111111111111111111111111111111111
1111111111111111111111110000000111111111111110000000111111111111110000000000001111111111111111111111111111111111111111111111111111
1111111111111111111111110000000111111111111111000000001111111111111000000000000111111111111111111111111111111111111111111111111111
1111111111111111111111110000000111111111111111000000001111111111111100000000000011111111111111111111111111111111111111111111111111
1111111111111111111111111000000011111111111111100000001111111111111110000000000000111111111111111111111111111111111111111111111111
1111111111111111111111111000000011111111111111100000000111111111111111100000000000011111111111111111111111111111111111111111111111
1111111111111111111111111000000001111111111111110000000111111111111111110000000000001111111111111111111111111111111111111111111111
1111111111111111111111111100000001111111111111110000000011111111111111111000000000000111111111111111111111111111111111111111111111
1111111111111111111111111110000000111111111111111000000011111111111111111100000000000011111111111111111111111111111111111111111111
1111111111111111111111111110000000011111111111111000000001111111111111111110000000000001111111111111111111111111111111111111111111
1111111111111111111111111111000000011111111111111000000000111111111111111111000000000000111111111111111111111111111111111111111111
1111111111111111111111111111000000001111111111111100000000011111111111111111100000000000011111111111111111111111111111111111111111
1111111111111111111111111111000000000111111111111100000000011111111111111111110000000000011111111111111111111111111111111111111111
1111111111111111111111111111100000000111111111111110000000011111111111111111111000000000001111111111111100000111111111111111110021
1111111111111111111111111111100000000111111111111111000111111111111111111111111100000000000111111111110000000001111111111111000021
1111111111111111111111111111100000000111111111111111111111111111111111111111111110000000000011111111100000000000111111111110000021
1111111111111111111111111111100000000111111111111111111111111111111111111111111111000000000000000000000000000000000011111100000021
1111111111111111111111111111110000000111111111111111111111111111111111111111111111100000000000000000000000000000000000010000000021
1111111111111111111111111111111111111111111111111111111111111111111111111111111111110000000000000000000000000000000000000000000021
1111111111111111111111111111111111111111111111111111111111111111111111111111111111111000000000000000000000000000000000000000000021
1111111111111111111111111111111111111111111111111111111111111111111111111111111111111000000000000000000001110000000000000000000011
1111111111111111111111111111111111111111111111111111111111111111111111111111111111111100000000000000000111111100000000000000001111
1111111111111111111111111111111111111111111111111111111111111111111111111111111111111110000000001111111111111111110000000001111111
1111111111111111111111111111111111111111111111111111111111111111111111111111111111111111000000000111111111111111111111111111111111
1111111111111111111111111111111111111111111111111111111111111111111111111111111111111111111111111111111111111111111111111111111111