<color=blue>Up</color> and <color=blue>right</color>...?
5.0
5.0
1111111111111111111111111111111111111111111111111111111111111111111111111111
1111111111111111111111111111111111111111111111111111111111111100222222222221
1111111111111111111111111111111111111111111111111111111111111000022222222221
1111111111111111111111111111111111111111111111111111111111110000000222222221
1111111111111111111111111111111111111111111111111111111111100000000022222221
1111111111111111111111111111111111111111111111111111111111000000000002222221
1111111111111111111111111111111111111111111111111111111110000000000000022221
1111111111111111111111111111111111111111111111111111111100000000000000002221
1111111111111111111111111111111111111111111111111111111000000000000000000221
1111111111111111111111111111111111111111111111111111110000000000000000000001
1111111111111111111111111111111111111111111111111111100000000000000000000001
1111111111111111111111111111111111111111111111111111000000000000000000000011
1111111111111111111111111111111111111111111111111110000000000000000000000111
1111111111111111111111111111111111111111111111111100000000000000000000001111
1111111111111111111111111111111111111111111111111000000000000000000000011111
1111111111111111111111111111111111111111111111110000000000000000000000111111
1111111111111111111111111111111111111111111111100000000000000000000001111111
1111111111111111111111111111111111111111111111000000000000000000000011111111
1111111111111111111111111111111111111111111110000000000000000000000111111111
1111111111111111111111111111111111111111111100000000000000000000001111111111
1111111111111111111111111111111111111111111000000000000000000000011111111111
1111111111111111111111111111111111111111110000000000000000000000111111111111
1111111111111111111111111111111111111111100000000000000000000001111111111111
1111111111111111111111111111111111111111000000000000000000000011111111111111
1111111111111111111111111111111111111110000000000000000000000111111111111111
1111111111111111111111111111111111111100000000000000000000001111111111111111
1111111111111111111111111111111111111000000000000000000000011111111111111111
1111111111111111111111111111111111110000000000000000000000111111111111111111
1111111111111111111111111111111111100000000000000000000001111111111111111111
1111111111111111111111111111111111000000000000000000000011111111111111111111
1111111111111111111111111111111110000000000000000000000111111111111111111111
1111111111111111111111111111111100000000000000000000001111111111111111111111
1111111111111111111111111111111000000000000000000000011111111111111111111111
1111111111111111111111111111110000000000000000000000111111111111111111111111
1111111111111111111111111111100000000000000000000001111111111111111111111111
1111111111111111111111111111000000000000000000000011111111111111111111111111
1111111111111111111111111110000000000000000000000111111111111111111111111111
1111111111111111111111111100000000000000000000001111111111111111111111111111
1111111111111111111111111000000000000000000000011111111111111111111111111111
1111111111111111111111110000000000000000000000111111111111111111111111111111
1111111111111111111111100000000000000000000001111111111111111111111111111111
1111111111111111111111000000000000000000000011111111111111111111111111111111
1111111111111111111110000000000000000000000111111111111111111111111111111111
1111111111111111111100000000000000000000001111111111111111111111111111111111
1111111111111111111000000000000000000000011111111111111111111111111111111111
1111111111111111110000000000000000000000111111111111111111111111111111111111
1111111111111111100000000000000000000001111111111111111111111111111111111111
1111111111111111000000000000000000000011111111111111111111111111111111111111
1111111111111110000000000000000000000111111111111111111111111111111111111111
1111111111111100000000000000000000001111111111111111111111111111111111111111
1111111111111000000000000000000000011111111111111111111111111111111111111111
1111111111110000000000000000000000111111111111111111111111111111111111111111
1111111111100000000000000000000001111111111111111111111111111111111111111111
1111111111000000000000000000000011111111111111111111111111111111111111111111
1111111110000000000000000000000111111111111111111111111111111111111111111111
1111111100000000000000000000001111111111111111111111111111111111111111111111
1111111000000000000000000000011111111111111111111111111111111111111111111111
1111110000000000000000000000111111111111111111111111111111111111111111111111
1111100000000000000000000001111111111111111111111111111111111111111111111111
1111000000000000000000000011111111111111111111111111111111111111111111111111
1110000000000000000000000111111111111111111111111111111111111111111111111111
1100000000000000000000001111111111111111111111111111111111111111111111111111
1000000000000000000000011111111111111111111111111111111111111111111111111111
1000000000000000000000111111111111111111111111111111111111111111111111111111
1000000000000000000001111111111111111111111111111111111111111111111111111111
1000000000000000000011111111111111111111111111111111111111111111111111111111
1000000000000000000111111111111111111111111111111111111111111111111111111111
1000000000000000001111111111111111111111111111111111111111111111111111111111
1000000000000000011111111111111111111111111111111111111111111111111111111111
1111111111111111111111111111111111111111111111111111111111111111111111111111
