Press <color=blue>up</color> on the right thumbstick!
5.0
5.0
11111111111111111111111111111111111111111111111111111111111
10000000000000000000000000000000000000000000000000000000001
10000000000000000000000000000000000000000000000000000002201
10000000000000000000000000000000000000000000000000000002201
10000000000000000000000000000000000000000000000000000002201
10000000000000000000000000000000000000000000000000000000001
11111111111111111111111111111111111111111111111111111111111
