You are in a maze of twisty passages
5.0
5.0
11111111111111111111111111111111111111111111111111111111111111111111111111111
11111111111111111111111111111111111111111111111111111111111222222222222222221
11111111111111111111111111111111111111111111111111111111111222222222222222221
11111111111111111111111111111111111111111111111111111111111222222222222222221
11111111111111111111111111111111111111111111111111111111111222222222222222221
11111111111111111111111111111111111111111111111111111111111222222222222222221
11111111111111111111111111111111111111111111111111111111111222222222222222221
11111111111111111111111111111111111111111111111111111111111222222222222222221
11111111111111111111111111111111111111111111111111111111111222222222222222221
11111111111111111111111111111111111111111111111111111111111222222222222222221
11111111111111111111111111111111111111111111111111111111111000000000000000001
11111111111111111111111111111111111111111111111111111111111000000000000000001
11111111111111111111111111111111111111111111111111111111111000000000000000001
11111111111111111111111111111111111111111111111111111111111000000000000000001
11111111111111111111111111111111111111111111111111111111111000000000000000001
11111111111111111111111111111111111111111111111111111111111000000000000000001
11111111111111111111111111111111111111111111111111111111111000000000000000001
11111111111111111111111111111111111111111111111111111111111000000000000000001
11111111111111111111111111111111111111111111111111111111111000000000000000001
11111111111111111111111111111111111111111111111111111111111000000000000000001
11111111111111111111111111111111111111111111111111111111111000000000000000001
11111111111111111111111111111111111111111111111111111111111000000000000000001
11111111111111111111111111111111111111111111111111111111111000000000000000001
11111111111111111111111111111111111111111111111111111111111000000000000000001
11111111111111111111111111111111111111111111111111111111111000000000000000001
11111111111111111111111111111111111111111111111111111111111000000000000000001
11111111111111111111111111111111111111111111111111111111111000000000000000001
11111111111111111111111111111111111111111111111111111111111000000000000000001
11111111111111111111111111111111111111111111111111111111111000000000000000001
11111111111111111111111111111111111111111111111111111111111000000000000000001
11111111111111111111111111111111111111111111111111111111111000000000000000001
11111111111111111111111111111111111111111111111111111111111000000000000000001
11111111111111111111111111111111111111111111111111111111111000000000000000001
11111111111111111111111111111111111111111111111111111111111000000000000000001
11111111111111111111111111111111111111111111111111111111111000000000000000001
11111111111111111111111111111111111111111111111111111111111000000000000000001
11111111111111111111111111111111111111111111111111111111111000000000000000001
11111111111111111111111111111111111111111111111111111111111000000000000000001
11111111111111111111111111111111111111111111111111111111111000000000000000001
11111111111111111111111111111111111111111111111111111111111000000000000000001
11111111111111111111111111111111111111111111111111111111111000000000000000001
11111111111111111111111111111111111111111111111111111111111000000000000000001
11111111111111111111111111111111111111111111111111111111111000000000000000001
11111111111111111111111111111111111111111111111111111111111000000000000000001
11111111111111111111111111111111111111111111111111111111111000000000000000001
11111111111111111111111111111111111111111111111111111111111000000000000000001
11111111111111111111111111111111111111111111111111111111110000000000000000011
11111111111111111111111111111111111111111111111111111111100000000000000000111
11111111111111111111111111111111111111111111111111111111000000000000000001111
11111111111111111111111111111111111111111111111111111110000000000000000011111
11111111111111111111111111111111111111111111111111111100000000000000000111111
11111111111111111111111111111111111111111111111111111000000000000000001111111
11111111111111111111111111111111111111111111111111110000000000000000011111111
11111111111111111111111111111111111111111111111111100000000000000000111111111
11111111111111111111111111111111111111111111111111000000000000000001111111111
11111111111111111111111111111111111111111111111110000000000000000011111111111
11111111111111111111111111111111111111111111111100000000000000000111111111111
11111111111111111111111111111111111111111111111000000000000000001111111111111
11111111111111111111111111111111111111111111110000000000000000011111111111111
11111111111111111111111111111111111111111111100000000000000000111111111111111
11111111111111111111111111111111111111111111000000000000000001111111111111111
11111111111111111111111111111111111111111110000000000000000011111111111111111
10000000000000000000000000000000000000000000000000000000000111111111111111111
10000000000000000000000000000000000000000000000000000000001111111111111111111
10000000000000000000000000000000000000000000000000000000011111111111111111111
10000000000000000000000000000000000000000000000000000000111111111111111111111
10000000000000000000000000000000000000000000000000000001111111111111111111111
10000000000000000000000000000000000000000000000000000011111111111111111111111
10000000000000000000000000000000000000000000000000000111111111111111111111111
11111111111111111111111111111111111111111111111111111111111111111111111111111
