Can you stop? Don't overshoot!
5.0
10
000000000000000000000000000000000000000000000000000000000000000011111111111111111111111111
000000000000000000000000000000000000000000000000000000000000000012222222222222222222222221
000000000000000000000000000000000000000000000000000000000000000010000000000000000000000001
000000000000000000000000000000000000000000000000000000000000000010000000000000000000000001
000000000000000000000000000000000000000000000000000000000000000010000000000000000000000001
000000000000000000000000000000000000000000000000000000000000000010000000000000000000000001
000000000000000000000000000000000000000000000000000000000000000010000000000000000000000001
000000000000000000000000000000000000000000000000000000000000000010000000000000000000000001
000000000000000000000000000000000000000000000000000000000000000010000000000000000000000001
000000000000000000000000000000000000000000000000000000000000000010000000000000000000000001
000000000000000000000000000000000000000000000000000000000000000010000000000000000000000001
000000000000000000000000000000000000000000000000000000000000000010000000000000000000000001
000000000000000000000000000000000000000000000000000000000000000010000000000000000000000001
000000000000000000000000000000000000000000000000000000000000000010000000000000000000000001
000000000000000000000000000000000000000000000000000000000000000010000000000000000000000001
000000000000000000000000000000000000000000000000000000000000000010000000000000000000000001
000000000000000000000000000000000000000000000000000000000000000010000000000000000000000001
000000000000000000000000000000000000000000000000000000000000000010000000000000000000000001
000000000000000000000000000000000000000000000000000000000000000010000000000000000000000001
000000000000000000000000000000000000000000000000000000000000000010000000000000000000000001
000000000000000000000000000000000000000000000000000000000000000010000000000000000000000001
000000000000000000000000000000000000000000000000000000000000000010000000000000000000000001
000000000000000000000000000000000000000000000000000000000000000010000000000000000000000001
000000000000000000000000000000000000000000000000000000000000000010000000000000000000000001
000000000000000000000000000000000000000000000000000000000000000010000000000000000000000001
000000000000000000000000000000000000000000000000000000000000000010000000000000000000000001
000000000000000000000000000000000000000000000000000000000000000010000000000000000000000001
000000000000000000000000000000000000000000000000000000000000000010000000000000000000000001
000000000000000000000000000000000000000000000000000000000000000010000000000000000000000001
000000000000000000000000000000000000000000000000000000000000000010000000000000000000000001
000000000000000000000000000000000000000000000000000000000000000010000000000000000000000001
000000000000000000000000000000000000000000000000000000000000000010000000000000000000000001
000000000000000000000000000000000000000000000000000000000000000010000000000000000000000001
000000000000000000000000000000000000000000000000000000000000000010000000000000000000000001
000000000000000000000000000000000000000000000000000000000000000010000000000000000000000001
000000000000000000000000000000000000000000000000000000000000000010000000000000000000000001
000000000000000000000000000000000000000000000000000000000000000010000000000000000000000001
000000000000000000000000000000000000000000000000000000000000000010000000000000000000000001
000000000000000000000000000000000000000000000000000000000000000010000000000000000000000001
000000000000000000000000000000000000000000000000000000000000000010000000000000000000000001
000000000000000000000000000000000000000000000000000000000000000010000000000000000000000001
000000000000000000000000000000000000000000000000000000000000000010000000000000000000000001
000000000000000000000000000000000000000000000000000000000000000010000000000000000000000001
000000000000000000000000000000000000000000000000000000000000000010000000000000000000000001
000000000000000000000000000000000000000000000000000000000000000010000000000000000000000001
000000000000000000000000000000000000000000000000000000000000000010000000000000000000000001
000000000000000000000000000000000000000000000000000000000000000010000000000000000000000001
000000000000000000000000000000000000000000000000000000000000000010000000000000000000000001
000000000000000000000000000000000000000000000000000000000000000010000000000000000000000001
000000000000000000000000000000000000000000000000000000000000000010000000000000000000000001
111111111111111111111111111111111111111111111111111111111111111110000000000000000000000001
100000000000000000000000000000000000000000000000000000000000000000000000000000000000000001
100000000000000000000000000000000000000000000000000000000000000000000000000000000000000001
100000000000000000000000000000000000000000000000000000000000000000000000000000000000000001
100000000000000000000000000000000000000000000000000000000000000000000000000000000000000001
100000000000000000000000000000000000000000000000000000000000000000000000000000000000000001
100000000000000000000000000000000000000000000000000000000000000000000000000000000000000001
100000000000000000000000000000000000000000000000000000000000000000000000000000000000000001
100000000000000000000000000000000000000000000000000000000000000000000000000000000000000001
100000000000000000000000000000000000000000000000000000000000000000000000000000000000000001
100000000000000000000000000000000000000000000000000000000000000000000000000000000000000001
100000000000000000000000000000000000000000000000000000000000000000000000000000000000000001
100000000000000000000000000000000000000000000000000000000000000000000000000000000000000001
100000000000000000000000000000000000000000000000000000000000000000000000000000000000000001
100000000000000000000000000000000000000000000000000000000000000000000000000000000000000001
100000000000000000000000000000000000000000000000000000000000000000000000000000000000000001
100000000000000000000000000000000000000000000000000000000000000000000000000000000000000001
100000000000000000000000000000000000000000000000000000000000000000000000000000000000000001
100000000000000000000000000000000000000000000000000000000000000000000000000000000000000001
111111111111111111111111111111111111111111111111111111111111111111111111111111111111111111
