Press <color=blue>down</color> on the right thumbstick!
55.0
5.0
11111111111111111111111111111111111111111111111111111111111
10000000000000000000000000000000000000000000000000000000001
10220000000000000000000000000000000000000000000000000000001
10220000000000000000000000000000000000000000000000000000001
10220000000000000000000000000000000000000000000000000000001
10000000000000000000000000000000000000000000000000000000001
11111111111111111111111111111111111111111111111111111111111
