A challenging path!
3
47
11111111111111111111111111111111111111111111111111
11111111111111111111111111111111111111111111111111
11000011111111111111111111111111111100001111111111
11000001111111111111111100001111111100000000111111
11000000111111111111100000001111110000000000111111
11000000011111111111100000001111100000000000011111
11100000001111111111000000001111100000000000011111
11110000000111111111000000000011100000111000011111
11110000000111111110000001000011100001111000011111
11111100000011111110000001000011100001111000011111
11111110000011111110000111000011100001100000011111
11111111000001111100000111000011100001000000011111
11111111000001111100001110000011100001000000111111
11111111000000111100001110000011100001000000111111
11111111100000111000001110000011000001000011111111
11111111110000011000011110000111000011000000111111
11111111110000000000011100001110000011110000000111
11111111110000000000011100001110000011110000000111
11111111111000000001111100000000000111110000000111
11111111111111100001111100000000000111111110000111
11111111111111111111111111100000001111111110000111
11111111111111111111111111100000001111111110000111
11111111111111111111111111111111111111111111000011
11000000000001111100001111111111111111111111000011
11000000000000001100001111111111111110000000000011
11000000000000000000000001111111111100000000000011
11000000000000000000000000111111111100000000011111
11000000000000000001000000111111111000000000011111
11100000011100000111100000111111110000001111111111
11100000011111111111000000111111110000001111111111
11110000011111011000000001111111110000011111111111
11111000011111000000001111111111110000001111111111
11111000001111000000111111111111110000000111111111
11111000001110000001111111111111110000000001111111
11111000001110000011111111111111111000000001111111
11111000000110000011110000000000011100000001111111
11111100000111222211100000000000011111000001111111
11111100000001111111000000000000011111100001111111
11111100000001111110000000000000011111100001111111
11111110000000111100000000000000011111100001111111
11111110000000110000000001100000011111100001111111
11111111100000010000000111100000000000000001111111
11111111100000000000001111100000000000000111111111
11111111111000000000001111100000000000000111111111
11111111111000000000111111100000000000000111111111
11111111111000000011111111111111111111111111111111
11111111111111111111111111111111111111111111111111
11111111111111111111111111111111111111111111111111
11111111111111111111111111111111111111111111111111
11111111111111111111111111111111111111111111111111
