Get to the goal!
48.0
48.0
01111111111111111111111111111111111111111111110000000000011111111111111111111111111111111111111111
01111111111111111111111111111111111111110000000000000000000000011111111111111111111111111111111111
01111111111111111111111111111111111100000000000000000000000000000001111111111111111111111111111111
01111111111111111111111111111111100000000000000000000000000000000000001111111111111111111111111111
01111111111111111111111111111110100000000000000000000000000000000000000011111111111111111111111111
01111111111111111111111111111000000000000000000000000000000000000000000000111111111111111111111111
01111111111111111111111111100000000000000000000000000000000000000000000000001111111111111111111111
01111111111111111111111110000000000000000000000000000000000000000000000000000011111111111111111111
01111111111111111111111110000000000000000000000000000000000000000000000000000001111111111111111111
01111111111111111111110000000000000000000000000000000000000000000000000000000000011111111111111111
01111111111111111111110000000000000000000000000000000000000000000000000000000000001111111111111111
01111111111111111111100000000000000000000000000000000000000000000000000000000000000011111111111111
01111111111111111100000000000000000000000000000000000000000000000000000000000000000001111111111111
01111111111111111000000000000000000000000000000000000000000000000000000000000000000000111111111111
01111111111111110000000000000000000000000000000000000000000000000000000000000000000000011111111111
01111111111111100000000000000000000000000000000000000000000000000000000000000000000000001111111111
01111111111111000000000000000000000000111000000000000000000000000000000000000000000000000111111111
01111111111110000000000000000000011111111111110000000000000000000000000000000000000000000011111111
01111111111110000000000000000001111111111111111100000000000000000000000000000000000000000001111111
01111111111100000000000000000111111111111111111110000000000000000000000000000000000000000000111111
01111111111100000000000000001111111111111111111111100000000000000000000000000000000000000000111111
01111111111000000000000000011111111111111111111111110000000000000000000000000000000000000000011111
01111111100000000000000001111111111111111111111111111000000000000000000000000000000000000000001111
01111111110000000000000001111111111111111111111111111100000000000000000000000000000000000000001111
01111111000000000000000011111111111111111111111111111110000000000000000000000000000000000000000111
01111111000000000000000111111111111111111111111111111111000000000000000000000000000000000000000011
01111111000000000000001111111111111111111111111111111111000000000000000000000000000000000000000011
01111110000000000000001111111111111111111111111111111111100000000000000000000000000000000000000001
01111100000000000000011111111111111111111111111111111111110000000000000000000000000000000000000001
01111000000000000000111111111111111111111111111111111111110000000000000000000000000000000000000001
01111000000000000000111111111111111111111111111111111111111000000000000000000000000000000000000111
01111000000000000001111111111111111111111111111111111111111000000000000000000000000000000000011111
01110000000000000001111111111111111111111111111111111111111100000000000000000000000000000001111111
01110000000000000011111111111111111111111111111111111111111100000000000000000000000000000111111111
01100000000000000011111111111111111111111111111111111111111110000000000000000000000000011111111111
01100000000000000011111111111111111111111111111111111111111110000000000000000000000001111111111111
01100000000000000111111111111111111111111111111111111111111100000000000000000000000111111111111111
01100000000000000111111111111111111111111111111111111111111000000000000000000000011111111111111111
01000000000000000111111111111111111111111111111111111111100000000000000000000001111111111111111111
01000000000000000111111111111111111111111111111111111111000000000000000000000111111111111111111111
01000000000000001111111111111111111111111111111111111100000000000000000000011111111111111111111111
01000000000000001111111111111111111111111111111111111000000000000000000001111111111111111111111111
00000000000000001111111111111111111111111111111111110000000000000000000111111111111111111111111111
00000000000000001111111111111111111111111111111111000000000000000000011111111111111111111111111111
00000000000000011111111111111111111111111111111110000000000000000001111111111111111111111111111111
00000000000000011111111111111111111111111111111100000000000000000111111111111111111111111111111111
00000000000000111111111111111111111111111111110000000000000000011111111111111111111111111111111111
00000000000000111111111111111111111111111111100000000000000001111111111111111111111111111111111111
00000000000000111111111111111111111111111110000000000000000111111111111111111111111111111111111111
00000000000000111111111111111111111111111100000000000000011111111111111111111111111111111111111111
00000000000000111111111111111111111111111222222222222001111111111111111111111111111111111111111111
00000000000000111111111111111111111111101111111111111111111111111111111111111111111111111111111111
00000000000000111111111111111111111111110000000000000001111111111111111111111111111111111111111111
00000000000000111111111111111111111111110000000000000000011111111111111111111111111111111111111111
00000000000000111111111111111111111111111000000000000000000111111111111111111111111111111111111111
00000000000000111111111111111111111111111110000000000000000001111111111111111111111111111111111111
00000000000000111111111111111111111111111111000000000000000000011111111111111111111111111111111111
00000000000000111111111111111111111111111111100000000000000000000111111111111111111111111111111111
00000000000000011111111111111111111111111111111000000000000000000001111111111111111111111111111111
00000000000000011111111111111111111111111111111100000000000000000000011111111111111111111111111111
00000000000000001111111111111111111111111111111111000000000000000000001111111111111111111111111111
01000000000000001111111111111111111111111111111111100000000000000000000011111111111111111111111111
01000000000000001111111111111111111111111111111111110000000000000000000000011111111111111111111111
01000000000000001111111111111111111111111111111111111100000000000000000000001111111111111111111111
01000000000000001111111111111111111111111111111111111110000000000000000000000011111111111111111111
01000000000000000111111111111111111111111111111111111111000000000000000000000000111111111111111111
01100000000000000111111111111111111111111111111111111111110000000000000000000000001111111111111111
01100000000000000111111111111111111111111111111111111111111000000000000000000000000011111111111111
01100000000000000011111111111111111111111111111111111111111100000000000000000000000000111111111111
01110000000000000011111111111111111111111111111111111111111110000000000000000000000000001111111111
01110000000000000011111111111111111111111111111111111111111100000000000000000000000000000011111111
01111000000000000001111111111111111111111111111111111111111100000000000000000000000000000000111111
01111000000000000001111111111111111111111111111111111111111100000000000000000000000000000000001111
01111000000000000000111111111111111111111111111111111111111000000000000000000000000000000000000011
01111100000000000000111111111111111111111111111111111111111000000000000000000000000000000000000001
01111100000000000000011111111111111111111111111111111111110000000000000000000000000000000000000001
01111110000000000000011111111111111111111111111111111111110000000000000000000000000000000000000011
01111111000000000000001111111111111111111111111111111111100000000000000000000000000000000000000011
01111111000000000000000111111111111111111111111111111111000000000000000000000000000000000000000111
01111111100000000000000111111111111111111111111111111110000000000000000000000000000000000000001111
01111111100000000000000011111111111111111111111111111110000000000000000000000000000000000000001111
01111111110000000000000001111111111111111111111111111100000000000000000000000000000000000000011111
01111111111000000000000000111111111111111111111111111000000000000000000000000000000000000000111111
01111111111100000000000000011111111111111111111111100000000000000000000000000000000000000000111111
01111111111110000000000000000111111111111111111111000000000000000000000000000000000000000001111111
01111111111110000000000000000011111111111111111110000000000000000000000000000000000000000011111111
01111111111111000000000000000000111111111111111000000000000000000000000000000000000000000111111111
01111111111111100000000000000000000111111111000000000000000000000000000000000000000000001111111111
01111111111111110000000000000000000000000000000000000000000000000000000000000000000000011111111111
01111111111111111000000000000000000000000000000000000000000000000000000000000000000000111111111111
01111111111111111100000000000000000000000000000000000000000000000000000000000000000001111111111111
01111111111111111110000000000000000000000000000000000000000000000000000000000000000011111111111111
01111111111111111111100000000000000000000000000000000000000000000000000000000000001111111111111111
01111111111111111111110000000000000000000000000000000000000000000000000000000000011111111111111111
01111111111111111111111100000000000000000000000000000000000000000000000000000000111111111111111111
01111111111111111111111110000000000000000000000000000000000000000000000000000011111111111111111111
01111111111111111111111111100000000000000000000000000000000000000000000000001111111111111111111111
01111111111111111111111111111000000000000000000000000000000000000000000000011111111111111111111111
01111111111111111111111111111110000000000000000000000000000000000000000011111111111111111111111111
01111111111111111111111111111111100000000000000000000000000000000000001111111111111111111111111111
01111111111111111111111111111111111100000000000000000000000000000001111111111111111111111111111111
01111111111111111111111111111111111111110000000000000000000000001111111111111111111111111111111111
01111111111111111111111111111111111111111111100000000000001111111111111111111111111111111111111111