What's the best way to do this...?
40
58
11111111111111111111111111111111111111111111111111111111111111111111111111111
11111111111111111111111111111111111111111111111111111111111111111111111111111
11111111111111111111111111111111111111000000111111111111111111111111111111111
11111111111111111111111111111111111111000000000001111111111111111111111111111
11111111111111111111111111111111111111000000000000000111111111111111111111111
11111111111111111111111111111111111111000000000000000000111111111111111111111
11111111111111111111111111111111111111000000000000000000001111111111111111111
11111111111111111111111111111111111111000000000000000000000011111111111111111
11111111111111111111111111111111111111000000000000000000000001111111111111111
11111111111111111111111111111111111111000000000000000000000000011111111111111
11111111111111111111111111111111111111000000000000000000000000001111111111111
11111111111111111111111111111111111111000000000000000000000000000111111111111
11111111111111111111111111111111111111111110000000000000000000000011111111111
11111111111111111111111111111111111111111111111000000000000000000001111111111
11111111111111111111111111111111111111111111111110000000000000000000111111111
11111111111111111111111111111111111111111111111111100000000000000000011111111
11111111111111111111111111111111111111111111111111110000000000000000001111111
11111111111111111111111111111111111111111111111111111000000000000000000111111
11111111111111111111111111111111111111111111111111111100000000000000000111111
11111111111111111111111111111111111111111111111111111110000000000000000011111
11111111111111111111111111111111111111111111111111111111000000000000000001111
11111111111111111111111111111111111111111111111111111111100000000000000001111
11111111111111111111111111111111111111111111111111111111110000000000000000111
11111111111111111111111111111111111111111111111111111111110000000000000000111
11111111111111111111111111111111111111111111111111111111111000000000000000111
11111111111111111111111111111111111111111111111111111111111000000000000000011
11111111111111111111111111111111111111111111111111111111111000000000000000011
11111111111111111111111111111111111111111111111111111111111100000000000000011
11111111111111111111111111111111111111111111111111111111111100000000000000001
11111111111111111111111111111111111111111111111111111111111100000000000000001
11111111111111111111111111111111111111111111111111111111111100000000000000001
11111111111111111111111111111111111111111111111111111111111100000000000000001
11111111111111111111111111111111111111111111111111111111111100000000000000001
11111111111111111111111111111111111111111111111111111111111100000000000000001
11111111111111111111111111111111111111111111111111111111111100000000000000001
11111111111111111111111111111111111111111111111111111111111000000000000000001
11111111111111111111111111111111111111111111111111111111111000000000000000001
11111111111111111111111111111111111111111111111111111111111000000000000000011
11111111111111111111111111111111111111111111111111111111110000000000000000011
11111111111111111111111111111111111111111111111111111111110000000000000000011
11111111111111111111111111111111111111111111111111111111100000000000000000111
11111111111111111111111111111111111111111111111111111111000000000000000000111
11111111111111111111111111111111111111111111111111111110000000000000000000111
11111111111111111111111111111111111111111111111111111100000000000000000001111
11111111111111111111111111111111111111111111111111111000000000000000000001111
11111111111111111111111111111111111111111111111111110000000000000000000011111
11111111111111111111111111111111111111111111111111100000000000000000000011111
11111111111111111111111111111111111111111111111110000000000000000000000111111
11111111111111111111111111111111111111111111111000000000000000000000001111111
11111111111111111111111111111111111111111112220000000000000000000000011111111
11111111111111111111111111111111111112222222220000000000000000000000111111111
11111111111111111111111111111111111112222222220000000000000000000001111111111
11111111111111111111111111111111111112222222220000000000000000000011111111111
11111111111111111111111111111111111112222222220000000000000000000111111111111
11111111111111111111111111111111111112222222220000000000000000001111111111111
11111111111111111111111111111111111112222222220000000000000000011111111111111
11111111111111111111111111111111111112222222220000000000000001111111111111111
11111111111111111111111111111111111112222222220000000000000011111111111111111
11111111111111111111111111111111111112222222220000000000001111111111111111111
11111111111111111111111111111111111112222222220000000001111111111111111111111
11111111111111111111111111111111111112222222220000000111111111111111111111111
11111111111111111111111111111111111112222222220001111111111111111111111111111
11111111111111111111111111111111111112222222221111111111111111111111111111111
11111111111111111111111111111111111111111111111111111111111111111111111111111
