Where does your acceleration need to point?
40
58
11111111111111111111111111111111111111111111111111111111111111111111111111111
11111111111111111111111111111111111111111111111111111111111111111111111111111
11111111111111111111111111111111000210000000111111111111111111111111111111111
11111111111111111111111111100000000210000000000001111111111111111111111111111
11111111111111111111111100000000000210000000000000000111111111111111111111111
11111111111111111111110000000000000210000000000000000000111111111111111111111
11111111111111111110000000000000000210000000000000000000001111111111111111111
11111111111111111000000000000000000210000000000000000000000011111111111111111
11111111111111110000000000000000000210000000000000000000000001111111111111111
11111111111111000000000000000000000210000000000000000000000000011111111111111
11111111111110000000000000000000000210000000000000000000000000001111111111111
11111111111100000000000000000000000210000000000000000000000000000111111111111
11111111111000000000000000000000001111111110000000000000000000000011111111111
11111111110000000000000000000011111111111111111000000000000000000001111111111
11111111100000000000000000001111111111111111111110000000000000000000111111111
11111111000000000000000000111111111111111111111111100000000000000000011111111
11111110000000000000000001111111111111111111111111110000000000000000001111111
11111100000000000000000011111111111111111111111111111000000000000000000111111
11111000000000000000000111111111111111111111111111111100000000000000000111111
11111000000000000000001111111111111111111111111111111110000000000000000011111
11110000000000000000011111111111111111111111111111111111000000000000000001111
11110000000000000000111111111111111111111111111111111111100000000000000001111
11100000000000000001111111111111111111111111111111111111110000000000000000111
11100000000000000001111111111111111111111111111111111111110000000000000000111
11000000000000000011111111111111111111111111111111111111111000000000000000111
11000000000000000011111111111111111111111111111111111111111000000000000000011
11000000000000000011111111111111111111111111111111111111111000000000000000011
11000000000000000111111111111111111111111111111111111111111100000000000000011
10000000000000000111111111111111111111111111111111111111111100000000000000001
10000000000000000111111111111111111111111111111111111111111100000000000000001
10000000000000000111111111111111111111111111111111111111111100000000000000001
10000000000000000111111111111111111111111111111111111111111100000000000000001
10000000000000000111111111111111111111111111111111111111111100000000000000001
10000000000000000111111111111111111111111111111111111111111100000000000000001
10000000000000000111111111111111111111111111111111111111111100000000000000001
10000000000000000011111111111111111111111111111111111111111000000000000000001
10000000000000000011111111111111111111111111111111111111111000000000000000001
10000000000000000011111111111111111111111111111111111111111000000000000000011
11000000000000000001111111111111111111111111111111111111110000000000000000011
11000000000000000001111111111111111111111111111111111111110000000000000000011
11000000000000000000111111111111111111111111111111111111100000000000000000111
11100000000000000000011111111111111111111111111111111111000000000000000000111
11100000000000000000001111111111111111111111111111111110000000000000000000111
11110000000000000000000111111111111111111111111111111100000000000000000001111
11110000000000000000000011111111111111111111111111111000000000000000000001111
11111000000000000000000001111111111111111111111111110000000000000000000011111
11111000000000000000000000111111111111111111111111100000000000000000000011111
11111100000000000000000000001111111111111111111110000000000000000000000111111
11111110000000000000000000000011111111111111111000000000000000000000001111111
11111111000000000000000000000000001111111110000000000000000000000000011111111
11111111100000000000000000000000000000000000000000000000000000000000111111111
11111111110000000000000000000000000000000000000000000000000000000001111111111
11111111111000000000000000000000000000000000000000000000000000000011111111111
11111111111100000000000000000000000000000000000000000000000000000111111111111
11111111111110000000000000000000000000000000000000000000000000001111111111111
11111111111111000000000000000000000000000000000000000000000000011111111111111
11111111111111110000000000000000000000000000000000000000000001111111111111111
11111111111111111000000000000000000000000000000000000000000011111111111111111
11111111111111111110000000000000000000000000000000000000001111111111111111111
11111111111111111111110000000000000000000000000000000001111111111111111111111
11111111111111111111111100000000000000000000000000000111111111111111111111111
11111111111111111111111111110000000000000000000001111111111111111111111111111
11111111111111111111111111111111100000000000111111111111111111111111111111111
11111111111111111111111111111111111111111111111111111111111111111111111111111
