Harder than it looks...
31
16
11111111111111111111111111111111111111111111111111
11111111111111111111111111111111111111111111111111
11111111111111111111111111111111111111111111111111
11111111111111111111111111111111111111111111111111
11111111111111111111111111111111111111111111111111
11111111111111111111111111111111111111111111111111
11111111111111111111111111111111111111111111111111
11111111111111111111111111011111111111111111111111
11111111111111111111111110001111111111111111111111
11111111111111111111111100000111111111111111111111
11111111111111111111111100000111111111111111111111
11111111111111111111111000000011111111111111111111
11111111111111111111110000000001111111111111111111
11111111111111111111110000000001111111111111111111
11111111111111111111100000000000111111111111111111
11111111111111111111000001100000011111111111111111
11111111111111111110000011110000001111111111111111
11111111000000000000000111111000000000000000011111
11111111000000000000001111111100000000000000011111
11111111100000000111111111111111110000000000111111
11111111110000001111111111111111111100000001111111
11111111110000011111111111111111111110000001111111
11111111111000011111111111111111111110000011111111
11111111111100011111111111111111111110000011111111
11111111111100001111111111111111111100000111111111
11111111111110000111111111111111111000001111111111
11111111111110000111111111111111111000001111111111
11111111111100000111111111111111111000000111111111
11111111111100001111111111111111111100000111111111
11111111111000001111111111111111111110000011111111
11111111110000011111111111111111111110000001111111
11111111110000011111111111111111111110000001111111
11111111100000001111111111111111111100000000111111
11111111000000000000001111111100001100000000011111
11111111000000000000001111111100001122222222211111
11111111111111111110000111111000001111111111111111
11111111111111111111000011110000011111111111111111
11111111111111111111100001100000111111111111111111
11111111111111111111100000000000111111111111111111
11111111111111111111110000000001111111111111111111
11111111111111111111111000000011111111111111111111
11111111111111111111111100000111111111111111111111
11111111111111111111111100000111111111111111111111
11111111111111111111111110001111111111111111111111
11111111111111111111111111011111111111111111111111
11111111111111111111111111111111111111111111111111
11111111111111111111111111111111111111111111111111
11111111111111111111111111111111111111111111111111
11111111111111111111111111111111111111111111111111
11111111111111111111111111111111111111111111111111
