Become a beautiful swan
26
27
11111111111111111111111111111111111111111111111111
11111111111111111111111111111111111111111111111111
11111111111111111111111111111111111111111111111111
11111111111111111111111111111111111111111111111111
11111111111111111111111111111111111111111111111111
11111111111111111111111111111111111111111111111111
11111111000001111111111111111111110000000011111111
11111000000000111111111111000000000000000001111111
11110000000000111111111000000000000000000000111111
11110000000000011111100000000000000000000000011111
11100000000000011110000000000000000000000000011111
11100000010000011110000000000011111111100000001111
11000000110000011100000000011111111111110000000111
11000000111000011100000001111111111111111000000111
11000001111000011100000000001111111111111000000111
11222221111000011100000000000011111111111100000111
11111111111000011100000000000000111111111110000011
11111111111000011111000000000000000111111110000011
11111111110000011111111100000000000011111110000011
11111111100000011111111111000000000011111110000011
11111111000000011111111111110000000001111111000011
11111110000000011111111111111110000001111111000011
11111100000001111111111111111111000001111111000011
11111100000011111111111111111110000001111111000011
11111000000011111111111111111110000001111111000011
11111000000111111111111111100000000011111111000011
11111000001111111111111111100000000011111111000011
11100000001111111111111111100000000111111110000011
11100000011111111111111111000000001111111110000011
11000000011111111111111110000000011111111110000011
11000000011111111111111110000000111111111110000011
11000000111111111111111110000011111111111110000111
11000000011111111111111100000011111111111100000111
11000000011111111111111100000011111111111100000111
11100000001111111111111100000111111111111100000111
11110000000111111111111111111111111111111100000111
11111000000001111111111111111111111111111000001111
11111000000000111111111100000011111111111000001111
11111100000000001111111000000001111111111000001111
11111110000000000111111000000001111111111000001111
11111110000000000011111000000000011111110000011111
11111111100000000000110000000000001111100000011111
11111111110000000000000000000000001111000000011111
11111111111110000000000000000000000111000000011111
11111111111111000000000000011000000010000000111111
11111111111111110000000000111100000000000001111111
11111111111111111111111111111100000000000011111111
11111111111111111111111111111110000000000011111111
11111111111111111111111111111111000000000111111111
11111111111111111111111111111111111111111111111111
