Wiggle wiggle
33
5.0
11111111111111111111111111111111111111111111111111111111111111111111111111111
11111111111111111111111111111111111111111111111111111111111111111111111111111
11111111111111111111111111111111111111111111111111111111111111111111111111111
11111111111111111111111111111111111111111111111111111111111111111111111111111
11111111111111111111111111111111111111111111111111111111111111111111111111111
11111111111111111111111111111111111111111111111111111111111111111111111111111
11111111111111111111111111111111111111111111111111111111111111111111111111111
11111111111111111111111111111111111111111111111111111111111111111111111111111
11111111111111111111111111111111111111111111111111111111111111111111111111111
11111111111111111111111111111111111111111111111111111111111111111111111111111
11111111111111111111111111111111111111111111111111111111111111111111111111111
11111111111111111111111111111111111111111222222222222111111111111111111111111
11111111111111111111111111111111111111111222222222222011111111111111111111111
11111111111111111111111111111111111111111222222222220001111111111111111111111
11111111111111111111111111111111111111111222222222000000111111111111111111111
11111111111111111111111111111111111111111222220000000000011111111111111111111
11111111111111111111111111111111111111111222000000000000001111111111111111111
11111111111111111111111111111111111111111220000000000000000111111111111111111
11111111111111111111111111111111111111111110000000000000000011111111111111111
11111111111111111111111111111111111111111111000000000000000001111111111111111
11111111111111111111111111111111111111111111100000000000000000111111111111111
11111111111111111111111111111111111111111111110000000000000000011111111111111
11111111111111111111111111111111111111111111111000000000000000001111111111111
11111111111111111111111111111111111111111111111100000000000000000111111111111
11111111111111111111111111111111111111111111111110000000000000000011111111111
11111111111111111111111111111111111111111111111111000000000000000001111111111
11111111111111111111111111111111111111111111111111100000000000000000111111111
11111111111111111111111111111111111111111111111111110000000000000000011111111
11111111111111111111111111111111111111111111111111111000000000000000001111111
11111111111111111111111111111111111111111111111111111100000000000000000111111
11111111111111111111111111111111111111111111111111111110000000000000000011111
11111111111111111111111111111111111111111111111111111111000000000000000001111
11111111111111111111111111111111111111111111111111111111100000000000000000111
11111111111111111111111111111111111111111111111111111111110000000000000000011
11111111111111111111111111111111111111111111111111111111111000000000000000001
11111111111111111111111111111111111111111111111111111111111000000000000000001
11111111111111111111111111111111111111111111111111111111111000000000000000001
11111111111111111111111111111111111111111111111111111111111000000000000000001
11111111111111111111111111111111111111111111111111111111110000000000000000011
11111111111111111111111111111111111111111111111111111111100000000000000000111
11111111111111111111111111111111111111111111111111111111000000000000000001111
11111111111111111111111111111111111111111111111111111110000000000000000011111
11111111111111111111111111111111111111111111111111111100000000000000000111111
11111111111111111111111111111111111111111111111111111000000000000000001111111
11111111111111111111111111111111111111111111111111110000000000000000011111111
11111111111111111111111111111111111111111111111111100000000000000000111111111
11111111111111111111111111111111111111111111111111000000000000000001111111111
11111111111111111111111111111111111111111111111110000000000000000011111111111
11111111111111111111111111111111111111111111111100000000000000000111111111111
11111111111111111111111111111111111111111111111000000000000000001111111111111
11111111111111111111111111111111111111111111110000000000000000011111111111111
11111111111111111111111111111111111111111111100000000000000000111111111111111
11111111111111111111111111111111111111111111000000000000000001111111111111111
11111111111111111111111111111111111111111110000000000000000011111111111111111
11111111111111111111111111111111110000000000000000000000000111111111111111111
11111111111111111111111111111111100000000000000000000000001111111111111111111
11111111111111111111111111111111000000000000000000000000011111111111111111111
11111111111111111111111111111110000000000000000000000000111111111111111111111
11111111111111111111111111111100000000000000000000000001111111111111111111111
11111111111111111111111111111000000000000000000000000011111111111111111111111
11111111111111111111111111110000000000000000000000000111111111111111111111111
11111111111111111111111111100000000000000000000000001111111111111111111111111
11111111111111111111111111000000000000000000000000011111111111111111111111111
11111111111111111111111110000000000000000000000000111111111111111111111111111
11111111111111111111111100000000000000000000000001111111111111111111111111111
11111111111111111111111000000000000000000000000011111111111111111111111111111
11111111111111111111110000000000000000000000000111111111111111111111111111111
11111111111111111111100000000000000000000000001111111111111111111111111111111
11111111111111111111000000000000000001111111111111111111111111111111111111111
11111111111111111110000000000000000011111111111111111111111111111111111111111
11111111111111111100000000000000000111111111111111111111111111111111111111111
11111111111111111000000000000000001111111111111111111111111111111111111111111
11111111111111110000000000000000011111111111111111111111111111111111111111111
11111111111111100000000000000000111111111111111111111111111111111111111111111
11111111111111000000000000000001111111111111111111111111111111111111111111111
11111111111110000000000000000011111111111111111111111111111111111111111111111
11111111111100000000000000000111111111111111111111111111111111111111111111111
11111111111000000000000000001111111111111111111111111111111111111111111111111
11111111110000000000000000011111111111111111111111111111111111111111111111111
11111111100000000000000000111111111111111111111111111111111111111111111111111
11111111000000000000000001111111111111111111111111111111111111111111111111111
11111110000000000000000011111111111111111111111111111111111111111111111111111
11111100000000000000000111111111111111111111111111111111111111111111111111111
11111000000000000000001111111111111111111111111111111111111111111111111111111
11110000000000000000011111111111111111111111111111111111111111111111111111111
11110000000000000000011111111111111111111111111111111111111111111111111111111
11110000000000000000011111111111111111111111111111111111111111111111111111111
11110000000000000000011111111111111111111111111111111111111111111111111111111
11111000000000000000001111111111111111111111111111111111111111111111111111111
11111100000000000000000111111111111111111111111111111111111111111111111111111
11111110000000000000000011111111111111111111111111111111111111111111111111111
11111111000000000000000001111111111111111111111111111111111111111111111111111
11111111100000000000000000111111111111111111111111111111111111111111111111111
11111111110000000000000000011111111111111111111111111111111111111111111111111
11111111111000000000000000001111111111111111111111111111111111111111111111111
11111111111100000000000000000111111111111111111111111111111111111111111111111
11111111111110000000000000000011111111111111111111111111111111111111111111111
11111111111111000000000000000001111111111111111111111111111111111111111111111
11111111111111100000000000000000111111111111111111111111111111111111111111111
11111111111111110000000000000000011111111111111111111111111111111111111111111
11111111111111111000000000000000001111111111111111111111111111111111111111111
11111111111111111100000000000000000111111111111111111111111111111111111111111
11111111111111111110000000000000000011111111111111111111111111111111111111111
11111111111111111111000000000000000001111111111111111111111111111111111111111
11111111111111111111100000000000000000011111111111111111111111111111111111111
11111111111111111111110000000000000000011111111111111111111111111111111111111
11111111111111111111111000000000000000011111111111111111111111111111111111111
11111111111111111111111100000000000000011111111111111111111111111111111111111
11111111111111111111111110000000000000011111111111111111111111111111111111111
11111111111111111111111111000000000000011111111111111111111111111111111111111
11111111111111111111111111100000000000011111111111111111111111111111111111111
11111111111111111111111111111111111111111111111111111111111111111111111111111
