Don't get blown away...
45
3.0
11111111111111111111111111111111111111111111111111
11111111111111111111111111111111111111111111111111
11110000011111111111111111111111111111111111111111
11000000000011111111111111111111111111111111111111
10000000000011111111111111111111111111111111111111
10000000000000011111111111111111111111111111111111
10000111000000011111111111111111111111111111111111
10000111100000011111111110000111111111111111111111
10001111100000011111111110000011111111111111111111
10001111100000111111111000000000011111111111111111
10001111000000111111111000000000011110000000001111
10000111000011110000110000000000011110000000001111
10000111000011110000000000011000011100000000001111
10000111000001100000000000111000011100000000001111
10000111000001100000000000111000011000000100001111
10000011000001100000000111110000011000001100001111
10000011000001100000111111000000110000001000001111
10000011000001110000011110000000110000001000000111
10000011000001110000011110000111110000011000000111
10000011100001111000001110000111100000111000000111
10000011100000011000001110000000000000111110000011
11000011100000011100000111100000000000111111000011
11000111110000011100000011100000000111100000000011
11000111110000011110000011100001111111100000000011
11000001111000011110000011111111111110000000111111
11000000111000011111222211111111111110000000111111
11100000111000001111111111111111111110000001111111
11100000111000000111111111111111111110000000111111
11110000111000000011111111111111111111100000000111
11100000111100000000000000000011111111110000000111
11100000111110000000000000000000011111110000000111
11100000111111000000000000000000000111111110000111
11000011111111000000000000000000000011111110000111
11000011111111110000000111110000000000110000000111
11000000001111111111111111111100000000000000011111
11000000001111111111111111111110000000000000011111
11111000000000011111111111111111110000000000011111
11111000000000001101111111111111110000001111111111
11111100000000000000111111110000111111111111111111
11111111000000000000011111100000011111111111111111
11111111111111100000011111000000000111111111111111
11111111111111000000111111000000000000001111111111
11111111111000000000111000000000000000001111111111
11111111111000000000111000000010000000000111111111
11111111111000000001100000011111111000000000011111
11111111111000000000000000011111111100000000000111
11111111111100000000000001111111111100000000000111
11111111111100000000000001111111111111000000000111
11111111111111110000001111111111111111111110000111
11111111111111111111111111111111111111111111111111
